50
50
PPPPPPPPPPPPPPPPPPPPPPPPPPPPPPPPPPPPPPPPPPPPPPPPPP
PPPPPPPPPPPPPPPPPPPPPPPPPPPPPPPPPPPPPPPPPPPPPPPPPP
PPPPPPPPPPPPPPPPPPPPPPPPPPPPPPPPPPPPPPPPPPPPPPPPPP
PPPBBSBSSSSSPPPTTTPPPTTTPPPTTTPPPTTTPPPSSSSSSSSPPP
PPPBBSBBSSSSSPPPTTTPPPTTTPPPTTTPPPTTTPPPSSSXSSSPPP
PPPBBSSBBSSSSSPPPGTTPPPTTTPPPXTTPPPTGTPPPSSSSSSPPP
PPPBBXPPPBBSPPPTTTPPPTTTPPPTTTPPPTTTPPPSSSPPPSSPPP
PPPBBSSPPPBBSPPPTTTPPPTTTPPPTTTPPPTTTPPPSSSPPPSPPP
PPPBBSSSPPPBBBPPPTTTPPPTTTPPPTTTPPPTTAPPPSSSPPPPPP
PPPBBSSSSPPPBBBPPPBTTPPPTTTPPPTTTPPPTASPPPSSSPPPPP
PPPBBSSBSSBBBBBBBBBBTTTTTTTTTTTTTTTTTASSAASAAAAPPP
PPPBBSSBSSBBBBBMMMBBTTMTTTTTTTTTPTTTTASSAAAATTTPPP
PPPBSSSSSSBBBBBBMBBBTMTMTTTTTTPTPTPTTAASSAAATTTPPP
PPPBBSSSSBBBBBBBMBBBMTTTMTTTTTTPPPTTTAAASSTTTTTPPP
PPPBBSSSSBBBBBBBMBBMMMTMMMTTTPPPPPPPTAAAASSTTDTPPP
PPPBBSSBSSBBBBBBMBBMTTTTTMTTTTTPPPTTTAAAASSTTTTPPP
PPPBSSBBBSSBBBBBMBBMTTTTTMTTGTPTPTPTTTTTGSTTTTTPPP
PPPSBSSBSBSSBSSMMMBMTTTTTMTTTTTTPTTTTTTTSSTTTTTPPP
PPPSSSSSSSDSSSSSBSBDTTTTTTTTTTTTTTTTTTTSSAATTTTPPP
PPPBSSSSBSBBSSBSSSSBTTTTTTTTTTTTTTTTTTTSSBBBBBBPPP
PPPBSSBBSSBBBSSBSBSSTTTTTTDTTTTTKTTTTTTSSBBBBBBPPP
PPPBBSSSSBBBBSSBBBBSSSDTTTSSSTTTTTTTTTTSSKBBBBBPPP
PPPBBSSSSBBBBSSBBBBBSSSSTSSSSSTTTTTTTTTTSSBBBBBPPP
PPPBBBSSSSBBBSSBBBBBTTSSSSTTTSTSTTTTTTSTSSSSBBBPPP
PPPTTTTSSTTTTTSSTTTTTTTTSSTTXTSSSTTSTSSSSBSSSBSPPP
PPPTTTSSTTTTTSSTTTSTSTTTSSSSTSSSSSSSSSSSAABBSSSPPP
PPPTTTTSSTTTTSSTTSSSSSTSSTSSSSTSTSXTSSSAABBBBSSPPP
PPPTGTSSTTTTTSSTSSTSTSSSTTTTSTTTTTTTTTSSBBBBBBSPPP
PPPTTSSSSTTTTSSSSTKTTTSTTTTTTTTTTTTTTSSAABBBBBKPPP
PPPTTTSSTTTSSTSSTTTTTTTTTTTTTTTTTTTTTTSSBBBBBBBPPP
PPPTSTSSTSSSSSSTTTTTTTTTTMTMMMMMTTTTTTTTSSBBBBBPPP
PPPSSSSTSSSTTSTTTTTTTTTTTMTMTTTMDTTTTTTSSBBBBBBPPP
PPPSTTSSSTTTTSSTTKTTTTTTTMTMTMTMTTTTTTSSBBBBBBBPPP
PPPTTASSAAAASSATTTTTTTTTTMTMTMTMTTTTTTTSSBBBBBBPPP
PPPTTSSAAAAASSATTTTTTTTTTMTMTMTMTTTTTTTSSBBBBBBPPP
PPPTTASSAAASSAATTTTGTTTTTMTMMMTMBBBBBBSSSBBBBBSPPP
PPPTSASSAAASSAATTTTKTTTTTMTTTTTMBBBBBSSBGSSBBSSPPP
PPPSSSSSSSSSSSATSTTSSTSSSMMMMMMMBBBSSSBSSBSSSSBPPP
PPPSTSSSSSSAASSSSSSSSSSSSSTSSSSSBSSSSBSSSBSSSSBPPP
PPPTTASSAAAAASSSTSSTTSTTTTTSSSSSSSSBASSBSSSAASSPPP
PPPTTASSAAAASSSBBBBBBBSBBBSSBSBBSBBAASSBASTAABSPPP
PPPTGAASSAASSASSSBSBBSSSBSSTBBBBAAAASSAAABTTBBBPPP
PPPTTSSSSSSSAAASSSSSSSASSSATBAAAAAABSSAABBTTBBBPPP
PPPSSSSTBSSBAAABBSBSSBAASBAAAAAABBBBSSBAABTTBBBPPP
PPPSSTSSBBBBSSABBBBBBBBABBSAABBBBBBSSBBBAATTBBBPPP
PPPTTSSTBBBBSSBBBBBBBBBBBBSSBBBBBBBSSBBBBAATBBBPPP
PPPTTTSSSSSSSSSSSSSBBKBBBBSSBBBBBBBBSSBBBAATBBBPPP
PPPPPPPPPPPPPPPPPPPPPPPPPPPPPPPPPPPPPPPPPPPPPPPPPP
PPPPPPPPPPPPPPPPPPPPPPPPPPPPPPPPPPPPPPPPPPPPPPPPPP
PPPPPPPPPPPPPPPPPPPPPPPPPPPPPPPPPPPPPPPPPPPPPPPPPP
