30
30
PPPPPPPPPPPPPPPPPPPPPPPPPPPPPP
PPPPPPPPPPPPPPPPPPPPPPPPPPPPPP
PPPPPPPPPPPPPPPPPPPPPPPPPPPPPP
PPPTSTTTTTTTTTAABSSSSBBBBSSPPP
PPPSSTTTGTTTTAABBBSSSBBBSSBPPP
PPPSSSSSMMMMMMMSSSBSSGBBBBBPPP
PPPSSTSSMSSSSSMSSBSSBBBAAABPPP
PPPTTTTSMSSSSSSSSSSSDBBABABPPP
PPPTGTTSMSSSSSSSBSSSSSBAABBPPP
PPPTTTTSMSSSMMMSBBSSBSBAABBPPP
PPPTTTTSMSSSSSMSBSSBBSBABABPPP
PPPTTTTSMMMMMMMSBBSSBBBSBBSPPP
PPPTTTTTTTTTTTAABSSSSSSBBBBPPP
PPPTTTTTTTTTTTAABSSBSSBBBSGPPP
PPPTTTTTTTTTTTBAASSSSBSBSSBPPP
PPPTTSTSSSSSSSSSBSSBSSSSSBBPPP
PPPTSTTSSSSSSSSSBBBSSBBSSBBPPP
PPPSSSSSTDBBBBBSSXBBSSBSSBBPPP
PPPSTTTTTTTTTAABBBBSSBBSSBBPPP
PPPTTAAAAATTTTAABBBPSBSBPBBPPP
PPPTTTTATTTTKTAABBSPPBSBPBBPPP
PPPTKATATTTTTTAABBBPSPSBPBKPPP
PPPTTTTATTTTTAABBBSPSSPBPBBPPP
PPPTTATATTTTTAABBBDPSSSPPBBPPP
PPPTTAAATTTTTAABBBSPBBSSPBBPPP
PPPTTTTDTTTTTAABBSSSSBSSBBBPPP
PPPSTSSSTTBBBBSSBBBBBBSSBBBPPP
PPPPPPPPPPPPPPPPPPPPPPPPPPPPPP
PPPPPPPPPPPPPPPPPPPPPPPPPPPPPP
PPPPPPPPPPPPPPPPPPPPPPPPPPPPPP
