75
75
PPPPPPPPPPPPPPPPPPPPPPPPPPPPPPPPPPPPPPPPPPPPPPPPPPPPPPPPPPPPPPPPPPPPPPPPPPP
PPPPPPPPPPPPPPPPPPPPPPPPPPPPPPPPPPPPPPPPPPPPPPPPPPPPPPPPPPPPPPPPPPPPPPPPPPP
PPPPPPPPPPPPPPPPPPPPPPPPPPPPPPPPPPPPPPPPPPPPPPPPPPPPPPPPPPPPPPPPPPPPPPPPPPP
PPPBBBBBBBBBBBBBBBBBBBBBBBBAASSTTSSSSSSSSSSSSSSSSSSSSSSSSSSSSTTSSSSSSTTGPPP
PPPBBBBBBBBBBBBSSSSKSSSSSSSSAASSTTSSSSSSSSSSSSSSSSSSSSSSSSSSSSTTSSSSTTTTPPP
PPPBBBBBBBBBBTTSBBSSSGSSSSSSAASSTTSSSSSSSSDSSSSSSSSSGSSSSSSSSSSTTSSSTTTTPPP
PPPSSSTSTSTSTTTTSSSSSSSSSSSAASSSTTSSSSSSSSSSSSSSSSSSSSSSSSSSSSSSTTSSTTTTPPP
PPPSSTTTTTTTTSSTTSSSSTTSSSAADSSTTSSSSSSSSSSSSSSSSSSSSSSSSSSSSSSTTSSSTTSSPPP
PPPPPTTPPPPPPPPTTPPPPPPPPPPPPPPPPPPPPPPPPPTTTSTSTSTSSSSSSSSSSSSTTSSTTTTSPPP
PPPTTSSSSSSSSSSSSTTTTAATTATAATAATASSSSSSSSSSSSSXSSSSSSSSSSSSSSSSTTTTSTTSPPP
PPPSSSSSSSSSSSSSSSTSAAAATTTTTTTTTTTTSSSSSSSSSSSSSSSSSSSSSSSGSSSSSTTTTTTSPPP
PPPSSSSSSSSSSSSSSSSSAAAAATATTATTATTTTSSSSSSSSSSSSSSSSSSSSSSSSSSSSTTTTTTSPPP
PPPSSSSSSSSSSSSSSSSSAAAAAAAAAAATTASSTTTSSSSSSSSSSSSSSTTTSSSSSSSSTTSTTTTSPPP
PPPSSSSSSSSGSSSSSSSSAAAAAAAAAAAATTSSSTTTTTSSSSSSTTTTTTTTTTTTSTSTTTSTTSSSPPP
PPPSSSSSSSSSSSSSSSSSAAAAAAAAAAAATTSSTSTTTTTTTTTTTTTTTTAATTTTTTTTTTTSTSTTPPP
PPPSSSSSSSSSSSSSSSSSATTTAAAATTATTATTTTTSSSTTTTTTSSSSSTBBBBBBTSTTTTTTTTTMPPP
PPPSSSSSSSSSSSTTXTTTTTTTTTAATTTATTTTSTSSSSSSSSSSSSSSSBBBBBBBBSSTSTTTSTTMPPP
PPPSSSSSSSSSTTTTTTTTTAAATTAAAATATTSSSSSSSSSSSSSSSSSSSBBPPPPPPPPPPPPPPPPPPPP
PPPSSSSSSSTTTTSSSSSSAAAAAAAAAAATTASSSSSSSSSSSSSSSSSSSBBBBBBBBSSSSSTTTTTMPPP
PPPSSSSTTTTTSSSSSSSSAAAAAAAAAAAATTSSSSSSSSSSSSSSSSSSSBBBBBBBBSSSSSTTSSTMPPP
PPPTTTTTTTSSSSSSSSSSAAAAAAAAAAATTASSSSSSSSSSSSSSSSSSSBBBBBBBBSSSSSSTTSTMPPP
PPPTTTTSSSSSSSSSSSSSAAAAAAAAAATTAASSSSSSSSSSSSGSSSSSSBBBBBBBBSSSSSSTTSTMPPP
PPPSSSSSSSSSSSSSSSSSAAAAAAAAAATTAASSSSSSSSSSSSSSSSSSSSSSSSSSSSSSSSSSTTTMPPP
PPPSSSSSSSSSSSSSSSSSSSSSSSSSSSDTTSSSDSSSSSSSSSSSSSSSDDSSSSSSSSSSSSSSTTTMPPP
PPPSSSSSSSSSSSSSSSSSSSSSSSSSSSSTTSSSSSSSSSSSSSSSSSSSSSSSSSSSSSSSSSSSTTTTPPP
PPPSSSSSSSSSSSSSSSSSSSSSSSSSSSSTTSSSSSSSSSSSSSSSSSSSSSSSSSSSGSSSSSSTTTTSPPP
PPPSSSSSSSSSSSSSSKKSSSSSSSSSSSSGGSSSSSAAAAAAAAAAAAAAAASSSSSSSSSSSSSSSTTSPPP
PPPSSSSSSSSSSSSSSSSSSSSSSSSSSSTTSSSSSSAAAAAKAAAAAAAAAASSSSSSSSSSSSSSTTTTPPP
PPPSSSSSSSSSSSSSSSSSSSSSSSSSSSSTTSSSSSAAAAAAAAAAAAAAAASSSSSSSSSSSSSSSTTTPPP
PPPSSSSSSSSSSSSSSSSSSSSSSSSSSSTTSSSSSSAAAAAAAAAAAAAAAASSSSTTTTTTTTTTTSTTPPP
PPPMMMMMMMMMMMMMMMSMMMMMMMMMMMMMMMMMMMMMMMMMMMMMMMMMMMMMMMMMMMMMMTMMMMMMPPP
PPPTTTTTTSSSSSSSSSSSSSMMMMMMMMMMMMMMMMMMMMMMMMMMMMMMMMMMMMMMTTTTTTTMTTTSPPP
PPPSTTSSTTSSSSSSSSSSSSSSSSSSSTTSSSSSSSAAAAAAAAAAAAAAAASSSSTMTTTTTTTMTTTSPPP
PPPSSSSSSTTSSSSTTTSSSSSSSSSSTTSSSSSSSSAAAAAAAAAAAAAAAASSSSTMTTTTTTTMTSTTPPP
PPPSSSSSSSTTTTTTTXTSSGSSSSSTTAASSSSTSTTAAAAAAAAAAAAAAATSSSTMTTTTTTTMTSSTPPP
PPPSSSSGSSSTTTTSSSTTTTTSSSSSTTAASSTTTTTTAAAAAAAAAAAAATTTTTTMTTTTTTTMTSTTPPP
PPPSSSSSSSTSSSSSSSSTTTTTSSTSTTSAATTSTSATTTAATTAAAAAATTSTTTTMTTTTTTTTTTTSPPP
PPPSSSSSSTTTSSSSSSSSSSSTTTTTTSTSTTSSSSAATTTTTTTTAAATTASSSSTMTTTTTTTMTTTTPPP
PPPTSSSTTTSTTSTSSSSSSSSSTTSTTTTTTSSSSSAAAATTAATTTTTTAASSSSTMMMMMMMMMTSSTPPP
PPPTTTTTTSSSTTTTTSTSSTSSSSSSSTSTAASSSSAAAAAAAAAATTTAAASSSSTTTTTTTTTTTSTTPPP
PPPSTTTSSSSSSTSTTTTTTTTTTSSSTTSAASSSSSAAAAAAAAAAAAAAAASSSSSSSSSSSSSSTTSTPPP
PPPSSSSSSSSSSSSSSTSTTSTTTTSSTTTSAASSSSAAAAAAAAAAAAAAAASSSSSSSSSSSSSTTSTTPPP
PPPSSSSSSSSTTTTTTTTTTTSSSTTTTTTTAATSSSSSSSSSSSSSSSSSSSSSSSSSSSSSSSSSTTSTPPP
PPPSSSSSSSSTMMMMMMMMMTSSSSTTTTSTTTTTSSSSSSSSSSSSSSSSSSSSSSSSSSSSSSSSTTSSPPP
PPPSSSSSSSSTMTTTTTTTMTSSBBSTTBBBSSBBBSSBSBSSBBBSSSSSSSSSSSTTTSSSSSSTTSSTPPP
PPPSSSSSSSSTMTTTTTTTMTSSBSBSTBAASTBTBSSBSBTSBSSSSSSSSSSSSSTTTTSSSSSSTTSSPPP
PPPSSSSSSSSTMTTMMMTTTTSSBSBSTBBBDSBBTSTBTBTTBTBSSSSSGSSSSSSSSTTTSSSTTSSTPPP
PPPSSSSSSSSTMTTMMMTTMTSSBSBSTBASSSBSBTSBTBSTBTBSSSSSSSSSKSTTTTSSSSTTSSSSPPP
PPPSSSSSSSSTMTTMMMTTMTSSBBSTSBBBSSBBBTSBBBSSBBBTTSSSTTSSSSSSTTTSSSSSTTSSPPP
PPPSSSSSSSSTMTTTTTTTMTSSSSSSTTSSSSSSSSSSSSSSSSSSSSSTTSTTTTSSSSSSSSSSSTSSPPP
PPPSSSSSSSSTMTTTXTTTMTSSSSSSSTTSSSSSSSSSSSSSSSSSSSSSTTTSSTTSSTTTTSTTTTTTPPP
PPPSSSSSSSSTMMMMMMMMMTSSSSSSTTSSSSSSSSSBBBSSBSSSSBBBTSSTSSTTTTTTTTTTTSTTPPP
PPPSSSSSSSSTTTTTTTTTTTAATTTTTTTTTTTSSSSBSBSKBSSSSSSBSSKSSSSTTSSSSTSSTTSSPPP
PPPSSSSSSSSSSSSSSSAAAAAATMMMMMMMMMTSSSSBBBSSBSSSSSBSSSSSSSSSTSSSTSSSTTSSPPP
PPPSSSKSSSSSSSSSSSAAAAAATMTTTTTTTMTSSSSBSSSSBSSSSBSSSSSSSSSTTTTTTTSTSTTTPPP
PPPSSSSSSSSSSSSSSSAAAAAATMTTTTTTTMTSSSSBSSSSBBBSSBBBSSSSSSTTSTTTATTTTTATPPP
PPPSSSSSSSSSSSSSSSAAAAAATMTTMMMTTTTSSSSSSSSSSSSSSSSSSSSTSTTSSSAAAATAATTAPPP
PPPSSSSSSSSGSSSSSSAAAAAATMTTMMMTTMTSSSSSSSSSSSSSSSTSSSTTTTSSSSAAAAAAATTAPPP
PPPSSSSSSSSSSSSSSSAAAAAATMTTMMMTTMTSSSSSSKSSSSSSGTTTTTTSTSSSSSAAAAAATTAAPPP
PPPSSSSSSGSSSSSSSSAAAAAATMTTTTTTTMTSSSSSSSSSSSSTTTSTTTSSSSSSSSAAAAAATTATPPP
PPPSSSSSSSSSSSSSSSAAAAAATMTTTTTTTMTSSSSSSSTTSTTTTSSSSSSSSSSSSSAAAAATTATTPPP
PPPSSSSSSSSSSSSSSSAAAAAATMMMMMMMMMTSSSSSSTTTTTTSSSSSSSSSSDSSSSAAAAAAATTAPPP
PPPSSSSSSSSKSSSSSSSSSSSSTTTTTTTTTTTTSSSTTTSSTSSSSSSSSSSSSSSSSSAAAAAATTTTPPP
PPPSSSSSSSSSSSSSSSSSSSSSSSSSTTSSSSTTTSTTTSSSSSSSSSSSSSSXSSSSSSAAAAATTAATPPP
PPPSBBBBBBBBBBBBBBSTSTSSSTSTTAASTTTSTTTSSSSSSGSSSSSSSSSSSSSSSSAAAAATTATTPPP
PPPSBBBBTBBBTTBBBBTTTTTSTTTTAATTTTSSSTSSSSSSSSSSSSSSSSSSSSSSSSAAAAATTAATPPP
PPPSBBBTTTBTTTTBBTTSTSTTTTTAASTTSSSSSASSSSSSSSSSSSSSSSSSSSSSSSAAAAATTATTPPP
PPPSTBTTBTTTBBTTTTSSSSSTTTSSAASSSSSSAAAASSSSSSSSSASSSSSSSSSSSSAAAATTATTAPPP
PPPTTTTBBBTBBBBTTBSSSSSTTSAAAAASSASAASAAASSSSSSAAAASSSSSSSSSSSAAAAATTTTAPPP
PPPTBTBBBBBBBBBBBBSASAASTTAASAAAAAAASSSSAASSAAAAASAAAASSSSSSSAAAAAAAATTTPPP
PPPSBBBBBBBBBBBBBBAAAAATTSSTTASAASASSSSSSAAAAAASSSSAAAAASSAAAAAAAAAATTTTPPP
PPPPPPPPPPPPPPPPPPPPPPPPPPPPPPPPPPPPPPPPPPPPPPPPPPPPPPPPPPPPPPPPPPPPPPPPPPP
PPPPPPPPPPPPPPPPPPPPPPPPPPPPPPPPPPPPPPPPPPPPPPPPPPPPPPPPPPPPPPPPPPPPPPPPPPP
PPPPPPPPPPPPPPPPPPPPPPPPPPPPPPPPPPPPPPPPPPPPPPPPPPPPPPPPPPPPPPPPPPPPPPPPPPP
PPPPPPPPPPPPPPPPPPPPPPPPPPPPPPPPPPPPPPPPPPPPPPPPPPPPPPPPPPPPPPPPPPPPPPPPPPP
